N,N,N,N,N,N,N,N,N,N,N,N,N
N,N,N,N,N,N,N,N,N,N,N,N,N
N,N,N,N,N,N,N,N,N,N,N,N,N
N,N,N,N,N,N,N,N,P,P,P,N,N
N,N,N,N,N,N,N,N,P,N,P,N,N
N,N,N,N,N,N,N,N,P,N,P,P,B
S,P,P,P,P,N,N,N,P,N,N,N,N
N,N,N,N,P,N,N,N,P,N,N,N,N
N,N,N,N,P,P,P,P,P,N,N,N,N
N,N,N,N,N,N,N,N,N,N,N,N,N